AMBITION=Maelstrom
AMBITION_100=Maelstrom
AMBITION_MOONCAKES=야망
AMETHYST=Command
ANNOUNCEMENT=Declaration
ARMADILLO=Armadillo
BASIC_MAGIC=Speed
BASIC_MANA=Vitality
BEAM=Pain
BESTCOUPLE=베스트 커플
BLIZZARD=Bulwark
BLOCK=Energy
CATS_EYE=Witchcraft
CHANCE=Chance
COAT=Dominance
CONVICT=Conviction
COURAGE=Frenzy
CRY=Madness
CURSE=Rage
DECISION=Strike
DIAMOND=Diamond
ECHO=Echo
EXPEDITION=Expedition
EXPEDITION_100=Expedition
FALLENLEAF=Sentinel
FALLENLEAF_100=Sentinel
FALLFOLIAGE=Defender
FATAL=Deadly
FERVOR=Enthusiastic
FERVOR_100=Enthusiastic
FERVOR_MOONCAKES=열의
FIGHT=Resistant
FIRST_STEP=Agony
FULFILL=Slayer
GIANT=Stone
GNOLL=Gnoll
GOBLIN=Goblin
GOLEM=Golem
GRAVEL=Toughness
HEAVY_RAIN=Chaos
HIGH_MAGIC=Brilliance
HIGH_MANA=Fury
HOPE=Destiny
ICE_STONE=Spellcraft
ITINERARY=Journey
IVORY=Resolve
JADE=Conjuring
JASMINE=Force
JASMINE_100=Force
JUDGMENT=Judgment
KOBOLD=Kobold
MEDIUM_MAGIC=Resurgence
MEDIUM_MANA=Rejuvenation
MIND=Berserker
MIND_100=Berserker
MIND_MOONCAKES=마음
MIST=Tempest
NOBLE=Noble
PASSION=Passion
PASSION_100=Passion
PERIDOT=Wizardry
PETAL=Bloodlust
PETAL_100=Bloodlust
PETAL_MOONCAKES=꽃잎
PINE=Accord
PROTECTION=Master
PUNISH=Divine Punishment
PUNISH_100=Divine Punishment
PVP_ENCHANT_LV40=Soldier
PVP_ENCHANT_LV50=Knight
PVP_ENCHANT_LV60=Bishop
PVP_ENCHANT_LV65=Rook
PVP_ENCHANT_LV70=Queen
PVP_ENCHANT_LV75=King
PVP_ENCHANT_LV80=Emperor
RAINBOW=Oblivion
RESOLVE=Skill
ROCK=Safety
SAND=Resistance
SAPPHIRE=Arcana
SHOWER=Restoration
SNOWBRANCH=Might
SPELL=Suffering
SPRING_RAIN=Vigilance
SPROUT=Zeal
STARLIGHT=Starlight
STATUE=Illusion
STIGMA=Stigma
TEST=Test
TRESURE=Ruin
TYPHOON=Palisade
VALOR=Valor
VALOR_100=Valor
VAMPIRE=Vampire
VITALITY=Healthy
VITALITY_100=Healthy
WAVE=Savvy
WEAK=Striking
WHISPER=Misery
WILLOW=Refuge
YETI=Yeti